00000000000
00000000000
00111111100
00100100100
00101110100
00111211100
00101110100
00100100100
00111111100
00000000000
00000000000