00000011111000000000000
11100011151000111000111
11111111511111121111141
11100011151000111000111
00000011111000000000000